NO ./proyect/textures/wall.xpm
SO ./proyect/textures/wall1.xpm
WE ./proyect/textures/wall2.xpm
EA ./proyect/textures/wall3.xpm

F 43,52,56
C 105,124,133


        1111111111111111111111111
        1000000000110000000000001
        1011000001110000000000001
        1001000000000000000000001
111111111011000001110000000000001
10000000001100000111011111D111111
11110111111111011100000010001
11110111111111011101010010001
11000000110101011100000010001
10000000000000001100000010001
10000000000000001101010010001
11000001110101011111011110N01
11010111 1110101 101111010001
11111111 1111111 111111111111